HW01 AAA
HW02 BBB
HW03 CCC
HW04 DDD
HW05 EEE